-16
61
-10
43
11111111111111111111111111111111111111111111111111111111111111111111111111111
10000000000000000000000000000001000000000000000000000000000000000000000000001
10000000000000000000000000000001000000000000000000000000000000000000000000001
10000000000000000000000000000001000000000000000000000000000000000000000000001
10000000000000000000000000000001000000000000000000000000000000000000000000001
10000000000000000000000000000001000000000000000000000000000000000000000000001
10000000000000000000000000000001000000000000000000000000000000000000000000001
10000000000000000000000000000001000000000000000000000000000000000000000000001
10000000000000000000000000000001000000000000000000000000000000000000000000001
10000000000000000000000000000001000000000000000000000000000000000000000000001
10000000000000000000000000000001000000000000000000000000000000000000000000001
10000000000000000000000000000001000000000000000000000000000000000000000000001
10000000000000000000000000000001000000000000000000000000000000000000000000001
10000000000000000000000000000001000000000000000000000000000000000000000000001
10000000000000000000000000000001000000000000000000000000000000000000000000001
10000000000000000000000000000001000000000000000000000000000000000000000000001
11111111111111111111111111111111111111111111111111111111111111111111111111111
10000000000000000000000000000000000000000000000000000000000000000000000000001
10000000000000000000000000000000000000000000000000000000000000000000000000001
11111111111111111111111111111111111111111111111111111111111111111111111111111
10000000000000000000000000000000000000000000000000000000000000000000000000001
10000000000000000000000000000000000000000000000000000000000000000000000000001
10000000000000000000000000000000000000000000000000000000000000000000000000001
11111111111111111111111110000001111111111111111111111111111111111111111111111
10000000000000000000000010000001000000000000000000000000000000000000000000001
10000000000000000000000010000001000000000000000000000000000000000000000000001
11111111111111111111111110000001111111111111111111111111111111111111111111111
10000000000000000000000010000001000000000000000000000000000000000000000000001
10000000000000000000000010000001000000000000000000000000000000000000000000001
10000000000000000000000010000001000000000000000000000000000000000000000000001
10000000000000000000000010000001000000000000000000000000000000000000000000001
10000000000000000000000010000001000000000000000000000000000000000000000000001
10000000000000000000000010000001000000000000000000000000000000000000000000001
10000000000000000000000010000001000000000000000000000000000000000000000000001
10000000000000000000000010000001000000000000000000000000000000000000000000001
10000000000000000000000010000001000000000000000000000000000000000000000000001
10000000000000000000000010000001000000000000000000000000000000000000000000001
10000000000000000000000010000001000000000000000000000000000000000000000000001
10000000000000000000000010000001000000000000000000000000000000000000000000001
10000000000000000000000010000001000000000000000000000000000000000000000000001
10000000000000000000000010000001000000000000000000000000000000000000000000001
10000000000000000000000010000001000000000000000000000000000000000000000000001
10000000000000000000000010000001000000000000000000000000000000000000000000001
10000000000000000000000010000001000000000000000000000000000000000000000000001
10000000000000000000000010000001000000000000000000000000000000000000000000001
10000000000000000000000010000001000000000000000000000000000000000000000000001
10000000000000000000000010000001000000000000000000000000000000000000000000001
10000000000000000000000010000001000000000000000000000000000000000000000000001
10000000000000000000000010000001000000000000000000000000000000000000000000001
10000000000000000000000010000001000000000000000000000000000000000000000000001
10000000000000000000000010000001000000000000000000000000000000000000000000001
10000000000000000000000010000001000000000000000000000000000000000000000000001
11111111111111111111111111111111111111111111111111111111111111111111111111111
